1111111111111111111111111111111111111111111111111111111111111111111111111111111111111111111111111111
1p00000011100000000000011100000000100000000100000100000011000010000010101010111000101010100001010001
1000111100000000001111000000111000000010010000101010000000010101111100000000000000000001010000000011
1000000111111111111111111111111111000000000000000111000000111100000011100001111000000000110011110011
1000000000001110000000001100000000000000000000000000001111111100000000101010100001010101110001110011
1000000011000001111000000011110000010000000000000111100000000001111000011011001100000000011000000011
1000000000000000000000110000000000000000000000000000001111110000000000111100010101011111000000111111
1000000000110000000000000001100000000000000000000100000011111111000000000001111000000000000000011111
1000000000000000000000000000000000000000000000000110000000111111111000000011000000011110000000001111
1000000010000011000001000000011000010000000001111111110000000000000001111111111100000001110000000011
1000000000000011100000000111000000000000000000110000000101111100001100000000000000111110000000011111
1000000000000000000011100000000000000000000011110000000000000000000001111111111001111000000001111111
1000000111111111111111111111111111000000010000000011111111110000000000000000000000111110111000001111
1000111100000000001111000000111000000010010100001111111111111111100000000001111111010000000100111111
1000000011100000000000011100000000100000000100000100000011000010000010101010111000101010100001010001
1000111100000000001111000000111000000010010000101010000000010101111100000000000000000001010000000011
1000000111111111111111111111111111000000000000000111000000111100000011100001111000000000110011110011
1000000000001110000000001100000000000000000000000000001111111100000000101010100001010101110001110011
1000000011000001111000000011110000010000000000000111100000000001111000011011001100000000011000000011
1000000000000000000000110000000000000000000000000000001111110000000000111100010101011111000000111111
1000000000110000000000000001100000000000000000000100000011111111000000000001111000000000000000011111
1000000000000000000000000000000000000000000000000110000000111111111000000011000000011110000000001111
1000000010000011000001000000011000010000000001111111110000000000000001111111111100000001110000000011
1000000000000011100000000111000000000000000000110000000101111100001100000000000000111110000000011111
1000000000000000000011100000000000000000000011110000000000000000000001111111111001111000000001111111
1000000111111111111111111111111111000000010000000011111111110000000000000000000000111110111000001111
1000111100000000001111000000111000000010010100001111111111111111100000000001111111010000000100111111
1000000011100000000000011100000000100000000100000100000011000010000010101010111000101010100001010001
1000111100000000001111000000111000000010010000101010000000010101111100000000000000000001010000000011
1000000111111111111111111111111111000000000000000111000000111100000011100001111000000000110011110011
1000000000001110000000001100000000000000000000000000001111111100000000101010100001010101110001110011
1000000011000001111000000011110000010000000000000111100000000001111000011011001100000000011000000011
1000000000000000000000110000000000000000000000000000001111110000000000111100010101011111000000111111
1000000000110000000000000001100000000000000000000100000011111111000000000001111000000000000000011111
1000000000000000000000000000000000000000000000000110000000111111111000000011000000011110000000001111
1000000010000011000001000000011000010000000001111111110000000000000001111111111100000001110000000011
1000000000000011100000000111000000000000000000110000000101111100001100000000000000111110000000011111
1000000000000000000011100000000000000000000011110000000000000000000001111111111001111000000001111111
1000000111111111111111111111111111000000010000000011111111110000000000000000000000111110111000001111
1000111100000000001111000000111000000010010100001111111111111111100000000001111111010000000100111111
1000000011100000000000011100000000100000000100000100000011000010000010101010111000101010100001010001
1000111100000000001111000000111000000010010000101010000000010101111100000000000000000001010000000011
1000000111111111111111111111111111000000000000000111000000111100000011100001111000000000110011110011
1000000000001110000000001100000000000000000000000000001111111100000000101010100001010101110001110011
1000000011000001111000000011110000010000000000000111100000000001111000011011001100000000011000000011
1000000000000000000000110000000000000000000000000000001111110000000000111100010101011111000000111111
1000000000110000000000000001100000000000000000000100000011111111000000000001111000000000000000011111
1000000000000000000000000000000000000000000000000110000000111111111000000011000000011110000000001111
1000000010000011000001000000011000010000000001111111110000000000000001111111111100000001110000000011
1000000000000011100000000111000000000000000000110000000101111100001100000000000000111110000000011111
1000000000000000000011100000000000000000000011110000000000000000000001111111111001111000000001111111
1000000111111111111111111111111111000000010000000011111111110000000000000000000000111110111000001111
1000111100000000001111000000111000000010010100001111111111111111100000000001111111010000000100111111
1000000011100000000000011100000000100000000100000100000011000010000010101010111000101010100001010001
1000111100000000001111000000111000000010010000101010000000010101111100000000000000000001010000000011
1000000111111111111111111111111111000000000000000111000000111100000011100001111000000000110011110011
1000000000001110000000001100000000000000000000000000001111111100000000101010100001010101110001110011
1000000011000001111000000011110000010000000000000111100000000001111000011011001100000000011000000011
10000000000000000000001100000000000000EEE00000000000001111110000000000111100010101011111000000111111
10000000001100000000000000011000000000EEE00000000100000011111111000000000001111000000000000000011111
1000000000000000000000000000000000000000000000000110000000111111111000000011000000011110000000001111
1000000010000011000001000000011000010000000001111111110000000000000001111111111100000001110000000011
1000000000000011100000000111000000000000000000110000000101111100001100000000000000111110000000011111
1000000000000000000011100000000000000000000011110000000000000000000001111111111001111000000001111111
1000000111111111111111111111111111000000010000000011111111110000000000000000000000111110111000001111
1000111100000000001111000000111000000010010100001111111111111111100000000001111111010000000100111111
1000000011100000000000011100000000100000000100000100000011000010000010101010111000101010100001010001
1000111100000000001111000000111000000010010000101010000000010101111100000000000000000001010000000011
1000000111111111111111111111111111000000000000000111000000111100000011100001111000000000110011110011
1000000000001110000000001100000000000000000000000000001111111100000000101010100001010101110001110011
1000000011000001111000000011110000010000000000000111100000000001111000011011001100000000011000000011
1000000000000000000000110000000000000000000000000000001111110000000000111100010101011111000000111111
1000000000110000000000000001100000000000000000000100000011111111000000000001111000000000000000011111
1000000000000000000000000000000000000000000000000110000000111111111000000011000000011110000000001111
1000000010000011000001000000011000010000000001111111110000000000000001111111111100000001110000000011
1000000000000011100000000111000000000000000000110000000101111100001100000000000000111110000000011111
1000000000000000000011100000000000000000000011110000000000000000000001111111111001111000000001111111
1000000111111111111111111111111111000000010000000011111111110000000000000000000000111110111000001111
1000111100000000001111000000111000000010010100001111111111111111100000000001111111010000000100111111
1000000011100000000000011100000000100000000100000100000011000010000010101010111000101010100001010001
1000111100000000001111000000111000000010010000101010000000010101111100000000000000000001010000000011
1000000111111111111111111111111111000000000000000111000000111100000011100001111000000000110011110011
1000000000001110000000001100000000000000000000000000001111111100000000101010100001010101110001110011
1000000011000001111000000011110000010000000000000111100000000001111000011011001100000000011000000011
1000000000000000000000110000000000000000000000000000001111110000000000111100010101011111000000111111
1000000000110000000000000001100000000011100000000000100000011111111000000000001111000000000000000011
1000000000000000000000000000000000000000000000000110000000111111111000000011000000011110000000001111
1000000010000011000001000000011000010000000001111111110000000000000001111111111100000001110000000011
1000000000000011100000000111000000000000000000110000000101111100001100000000000000111110000000011111
1000000000000000000011100000000000000000000011110000000000000000000001111111111001111000000001111111
1000000111111111111111111111111111000000010000000011111111110000000000000000000000111110111000001111
1000111100000000001111000000111000000010010100001111111111111111100000000001111111010000000100111111
1000000011100000000000011100000000100000000100000100000011000010000010101010111000101010100001010001
1000111100000000001111000000111000000010010000101010000000010101111100000000000000000001010000000011
1000000111111111111111111111111111000000000000000111000000111100000011100001111000000000110011110011
1000000000001110000000001100000000000000000000000000001111111100000000101010100001010101110001110011
1000000011000001111000000011110000010000000000000111100000000001111000011011001100000000011000000011
1000000000000000000000110000000000000000000000000000001111110000000000111100010101011111000000111111
1000000000110000000000000001100000000000000000000100000011111111000000000001111000000000000000011111
1000000000000000000000000000000000000000000000000110000000111111111000000011000000011110000000001111
1111111111111111111111111111111111111111111111111111111111111111111111111111111111111111111111111111






