1111111111111111111111111111111111111111
1p00000000000000000000000000000000000001
1000000000000000000000000000000000000001
1000000000000000000000000000000000000001
1000111111111111110011111111111111110001
1000100000000000000000000000000000010001
1000100000000000001100000000000000010001
1000100000000000001100000000000000010001
1000100000000000001100000000000000010001
1000100000000000001100000000000000010001
1000100000000000001100000000000000010001
1000100000000000001100000000000000010001
1000100000000000001100000000000000010001
1000100000000000000000000000000000010001
1000100011111111000000111111111100010001
1000100000000000000000000000000000010001
1000100000000000001100000000000000010001
1000100000000000001100000000000000010001
1000100000000000001100000000000000010001
1000100000000000001100000000000000010001
1000100000000000001100000000000000010001
1000100000000000001100000000000000010001
1000100000000000001100000000000000010001
1000100000000000001100000000000000010001
1000100000000000000000000000000000010001
1000111111111111110011111111111111110001
1000000000000000000000000000000000000001
1000000000000000000000000000000000000001
1000000000000000000000000000000000000001
1111111111111111111111111111111111111111
