1111111111111111111111111111111111111111111111111111111111111111111111111111111111111111111111111111
1100000000000000000011111111111111111000000000000001010100000001111111110111111111111111110000001111
1000000001110000000001100000000111000000001111111100000000000100000000000001110000000000000011111111
1000000000000001111110000000010000000001111111111000000000000000000000000000000000000000011111111111
1000p00011100000000001110000000111000000000000000000001110000111111100011110000111100000000001111111
1000000000000111111111111100000000000000000000001111111111100100000000000000011111111000111000000111
1000000111000001111110000111111000011000011111111000000011111111000000000001111111001110000000000011
1000000000000000000000000000000000000000000000000000000000000111100000000000000001100000011111110111
1000000111111000000000111111000000001000000000000000000111110000111111110000111111111111000000000001
1000000000000111111111111100000000000000000000001111111111100100000000000100000000000000000000111111
1000000011100000000001110000000111000000000000000000001110000100000000011100000111111100000110111111
1000000000000001111110000000010000001111111111111110000000011111100001111100000111111111101100000001
1000000001110000000001100000000111000000000000000000001100000100011100000000000000001111000000111101
1000000000000001011110000010000000000000000000000001011110000100011111111111100000000111111101111101
1000001111111100000000000001111111100000011111110000011111110100000000000000000111000000000000000001
1100000000000000000011111111111111111000000000000001010100000001111111110111111111111111110000001111
1000000001110000000001100000000111000000001111111100000000000100000000000001110000000000000011111111
1000000000000001111110000000010000000001111111111000000000000000000000000000000000000000011111111111
1000000011100000000001110000000111000000000000000000001110000111111100011110000111100000000001111111
1000000000000111111111111100000000000000000000001111111111100100000000000000011111111000111000000111
1000000111000001111110000111111000011000011111111000000011111111000000000001111111001110000000000011
1000000000000000000000000000000000000000000000000000000000000111100000000000000001100000011111110111
1000000111111000000000111111000000001000000000000000000111110000111111110000111111111111000000000001
1000000000000111111111111100000000000000000000001111111111100100000000000100000000000000000000111111
1000000011100000000001110000000111000000000000000000001110000100000000011100000111111100000110111111
1000000000000001111110000000010000001111111111111110000000011111100001111100000111111111101100000001
1000000001110000000001100000000111000000000000000000001100000100011100000000000000001111000000111101
1000000000000001011110000010000000000000000000000001011110000100011111111111100000000111111101111101
1000001111111100000000000001111111100000011111110000011111110100000000000000000111000000000000000001
1100000000000000000011111111111111111000000000000001010100000001111111110111111111111111110000001111
1000000001110000000001100000000111000000001111111100000000000100000000000001110000000000000011111111
1000000000000001111110000000010000000001111111111000000000000000000000000000000000000000011111111111
1000000011100000000001110000000111000000000000000000001110000111111100011110000111100000000001111111
1000000000000111111111111100000000000000000000001111111111100100000000000000011111111000111000000111
1000000111000001111110000111111000011000011111111000000011111111000000000001111111001110000000000011
1000000000000000000000000000000000000000000000000000000000000111100000000000000001100000011111110111
1000000111111000000000111111000000001000000000000000000111110000111111110000111111111111000000000001
1000000000000111111111111100000000000000000000001111111111100100000000000100000000000000000000111111
1000000011100000000001110000000111000000000000000000001110000100000000011100000111111100000110111111
1000000000000001111110000000010000001111111111111110000000011111100001111100000111111111101100000001
1000000001110000000001100000000111000000000000000000001100000100011100000000000000001111000000111101
1000000000000001011110000010000000000000000000000001011110000100011111111111100000000111111101111101
1000001111111100000000000001111111100000011111110000011111110100000000000000000111000000000000000001
1100000000000000000011111111111111111000000000000001010100000001111111110111111111111111110000001111
1000000001110000000001100000000111000000001111111100000000000100000000000001110000000000000011111111
1000000000000001111110000000010000000001111111111000000000000000000000000000000000000000011111111111
1000000011100000000001110000000111000000000000000000001110000111111100011110000111100000000001111111
1000000000000111111111111100000000000000000000001111111111100100000000000000011111111000111000000111
1000000111000001111110000111111000011000011111111000000011111111000000000001111111001110000000000011
1000000000000000000000000000000000000000000000000000000000000111100000000000000001100000011111110111
1000000111111000000000111111000000001000000000000000000111110000111111110000111111111111000000000001
1000000000000111111111111100000000000000000000001111111111100100000000000100000000000000000000111111
1000000011100000000001110000000111000000000000000000001110000100000000011100000111111100000110111111
1000000000000001111110000000010000001111111111111110000000011111100001111100000111111111101100000001
1000000001110000000001100000000111000000000000000000001100000100011100000000000000001111000000111101
1000000000000001011110000010000000000000000000000001011110000100011111111111100000000111111101111101
1000001111111100000000000001111111100000011111110000011111110100000000000000000111000000000000000001
1100000000000000000011111111111111111000000000000001010100000001111111110111111111111111110000001111
100000000111000000000110000000011100000000111111110000EEE0000100000000000001110000000000000011111111
100000000000000111111000000001000000000111111111100000EEE0000000000000000000000000000000011111111111
1000000011100000000001110000000111000000000000000000001110000111111100011110000111100000000001111111
1000000000000111111111111100000000000000000000001111111111100100000000000000011111111000111000000111
1000000111000001111110000111111000011000011111111000000011111111000000000001111111001110000000000011
1000000000000000000000000000000000000000000000000000000000000111100000000000000001100000011111110111
1000000111111000000000111111000000001000000000000000000111110000111111110000111111111111000000000001
1000000000000111111111111100000000000000000000001111111111100100000000000100000000000000000000111111
1000000011100000000001110000000111000000000000000000001110000100000000011100000111111100000110111111
1000000000000001111110000000010000001111111111111110000000011111100001111100000111111111101100000001
1000000001110000000001100000000111000000000000000000001100000100011100000000000000001111000000111101
1000000000000001011110000010000000000000000000000001011110000100011111111111100000000111111101111101
1000001111111100000000000001111111100000011111110000011111110100000000000000000111000000000000000001
1100000000000000000011111111111111111000000000000001010100000001111111110111111111111111110000001111
1000000001110000000001100000000111000000001111111100000000000100000000000001110000000000000011111111
1000000000000001111110000000010000000001111111111000000000000000000000000000000000000000011111111111
1000000011100000000001110000000111000000000000000000001110000111111100011110000111100000000001111111
1000000000000111111111111100000000000000000000001111111111100100000000000000011111111000111000000111
1000000111000001111110000111111000011000011111111000000011111111000000000001111111001110000000000011
1000000000000000000000000000000000000000000000000000000000000111100000000000000001100000011111110111
1000000111111000000000111111000000001000000000000000000111110000111111110000111111111111000000000001
1000000000000111111111111100000000000000000000001111111111100100000000000100000000000000000000111111
1000000011100000000001110000000111000000000000000000001110000100000000011100000111111100000110111111
1000000000000001111110000000010000001111111111111110000000011111100001111100000111111111101100000001
1000000001110000000001100000000111000000000000000000001100000100011100000000000000001111000000111101
1000000000000001011110000010000000000000000000000001011110000100011111111111100000000111111101111101
1000001111111100000000000001111111100000011111110000011111110100000000000000000111000000000000000001
1100000000000000000011111111111111111000000000000001010100000001111111110111111111111111110000001111
1000000001110000000001100000000111000000001111111100000000000100000000000001110000000000000011111111
1000000000000001111110000000010000000001111111111000000000000000000000000000000000000000011111111111
1000000011100000000001110000000111000000000000000000001110000111111100011110000111100000000001111111
1000000000000111111111111100000000000000000000001111111111100100000000000000011111111000111000000111
1000000111000001111110000111111000011000011111111000000011111111000000000001111111001110000000000011
1000000000000000000000000000000000000000000000000000000000000111100000000000000001100000011111110111
1000000111111000000000111111000000001000000000000000000111110000111111110000111111111111000000000001
1000000000000111111111111100000000000000000000001111111111100100000000000100000000000000000000111111
1000000011100000000001110000000111000000000000000000001110000100000000011100000111111100000110111111
1000000000000001111110000000010000001111111111111110000000011111100001111100000111111111101100000001
1000000001110000000001100000000111000000000000000000001100000100011100000000000000001111000000111101
1000000000000001011110000010000000000000000000000001011110000100011111111111100000000111111101111101
1000001111111100000000000001111111100000011111110000011111110100000000000000000111000000000000000001
1111111111111111111111111111111111111111111111111111111111111111111111111111111111111111111111111111






