1111111111111111111111111111111111111111111111111111111111111111111111111111111111111111111111111111
1p00000000000000000000000000000000000000000000000111111111111111111111111111111111111111111111111111
1000000000000000000000000000000000000000000000000000000000000000000000000000000000000000000000000011
1011111111111111111111111111111111111110000000000000000000000000000000000000001111100000001111100001
1010000000000000000000000000000000000000000010010110000000111111111111111111111111111111111000000111
1010111111111111111111111111111111111100000000000000111111111111111111111111111111110011111111111111
1000000000000000000000000000000000000000000000000100000000000001000111111111111100000000100000000011
1011111111111111111111111111111111111110000000000000000000000000000011001111111110000000000111100011
1010000000000000000000000000000000000000000010010111111111110000000100000000010100001111000000000111
1010111111111111111111111111111111111011000000000000000000000000000000000011111111111000000000000011
1010100000000000000000000000000000000000000000000000011111111110000000000000000000000000000000011111
1010101111111111111111111111111111000000000000000000000000000000000000001111000000110000000000011111
1010101000000000000000000000000000010010010010010111111111111000000000011111100000000111110000000001
1010101011111111111111111110000000000000000000010111111111111000000000011111111100000000000000000001
1010101010000000000000000000010010010010010010010111111110000000000111111111111111111100000000011111
1010101010111111111111111110000000000000010010010101010101100001111111000000000001001001001001000001
1010101010000000000000000000010010010010010010010111111110000000000111111111111111111100000000011111
1010101010111111111111100000000000000000000000000001010101111110001111111000000000001001001111000011
1010101010100000000000010010010010010010010010010100000000000000001000011111111111111110000000000001
1010101010101111111110010000000000000000000000000000000000111111111100000011111101001001001000000011
1010101010101000000010010010010010010010010010010100000111111110000000000000000000000000111111111111
1010101010101011110010010010010010000000000000000000000000000000001111111111100000000000000000011111
1000000000000000010010000000000000000000000000000000000000000000000000000011111110000000000001111111
1010101010100000000000010010010010010010010010010100000000000000011111111111000000000000000000111111
1010101010101111111110000000000000000000000000000000000000000000111111111110000000000000000001111111
1010101010101000000000000000000000000000000000001000000000000000111111111110000000000000000001111111
1010101010101011110010010010010010010010010010001000000000000000111111111110000000000000000001111111
1000000000000000010010010010010010010010010010001000000000000000000000000000111111111111011111111111
1111111111111111111111111111111111111110000000000000000000000000000000000000000000000000000000000001
1000000000000000000000000000000000000000000000000111000000000111111111000000000000001111000000000001
1011111111111111111111111111111111111111111000000100011111110000000000000000111110000000000001110001
1010000000000000000000000000000000000000000010010100000000000111100000000001110011000101010101001011
1010111111111111111111111111111111100000000000000110010101010100000001010101010000001010101010010001
1010100000000000000000000000000000000000010010010111111100000000101010100000000001010000000000001111
1010101111111111111111111111111111111010000000010100000001010100000000000001010101000000000001111111
1010101000000000000000000000000000010010010010010111100000000000000000000000000000000000000111111111
1010101011111111111111111111111010010010010010010111111111110000000000000000000000000000111111111111
1010101010000000000000000000010010010010000000010111111111111100000000000000000000000001111111111111
1010101010111111111111111110010010010010010010010111111000000000000000000011111110000000111111111111
1010101010100000000000010010010010010010010010010011111111111110000000000000000000000000000000000001
1010101010101111111110010010010010010010000000010011111100000000000000000000000011110000000000000001
1010101010101000000010010010010010010010010010010000000000000000000011111111111110000000000000111101
1010101010101011110010010010010010010010000000000000000000011111111111000000001111100000011010000001
1000000000000000010010010010010010010010010010010111111100000001010000000000000000000110000000101011
1010100100101010101001001111111000000001010100101010000000000110000000011111111000111111111000101111
1010101010000000000000000000010010010010010010010111111111111100000000000000000000000001111111111111
1010101010111111111111111110010010010010010010010111111000000000000000000011111110000000111111111111
1010101010100000000000010010010010010010010010010011111111111110000000000000000000000000000000000001
1010101010101111111110010010010010010000000000010011111100000000000000000000000011110000000000000001
1010101010101000000010010010010010010010010010010000000000000000000011111111111110000000000000111101
1010101010101011110010010010010010010000000000000000000000011111111111000000001111100000011010000001
1000000000000000010010010010010010010010010010010111111100000001010000000000000000000110000000101011
1010100100101010101001001111111000000001010100101010000000000110000000011111111000111111111000101111
1010101000000000000000000000000000010010000000000111000000000000000011010110000000001100000000000101
1010101010000000000000000000010010010010010010010111111111111100000000000000000000000001111111111111
1010101010111111111111111110010010010010010010010111111000000000000000000011111110000000111111111111
1010101010100000000000010010010010010010010010010011111111111110000000000000000000000000000000000001
1010101010101111111110010010010010010010010010010011111100000000000000000000000011110000000000000001
1010101010101000000010010010010010010010010010010000000000000000000011111111111110000000000000111101
1010101010101011110010010010010010010010010010010100000000011111111111000000001111100000011010000001
1000000000000000010010010010010010010010000010010111111100000001010000000000000000000110000000101011
1010100100101010101001001111111000000001000000000010000000000110000000011111111000111111111000101111
1010101010000000000000000000010010010010000000000111111111111100000000000000000000000001111111111111
1010101010111111111111111110010010010010000000000000000000000000000000000011111110000000111111111111
1010101010100000000000010010010010010010010010010011111111111110000000000000000000000000000000000001
1010101010101111111110010010010010010010000010000001111100000000000000000000000011110000000000000001
1010101010101000000010010010010010010010000010010000000000000000000011111111111110000000000000111101
1010101010101011110010010010010010010010000010000000000000011111111111000000001111100000011010000001
1000000000000000010010010010010010010010000010010111111100000001010000000000000000000110000000101011
1010100100101010101001001111111000000001000100000000000000000110000000011111111000111111111000101111
1010101010000000000000000000010010010010010010010000001111111100000000000000000000000001111111111111
1010101010111111111111111110010010010010000000000000000000000000000000000011111110000000111111111111
1010101010100000000000010010010010010010010010010000000001111110000000000000000000000000000000000001
1010101010101111111110010010010011111111010011100000000000000000000000000011110000000000000001111111
1010101010101000000010010010010010010010010010000000000000000000000011111111111110000000000000111101
1010101010101011110010010010010010010010010010010100000000011111111111000000001111100000011010000001
1000000000000000010010010010010010010010010010000000000000000001010000000000000000000110000000101011
1010100100101010101001001111111000000001010100101010000000000110000000011111111000111111111000101111
1000000000000000010010010010010010010010010010000000EEEE00011111111111000000000000110101010010110011
1111111111111111100000000000111111111111111111110000EEEE00000000000000000000000001111111110000000111
1000000000000000000000000000000000000000000000000100000000111111111100000000100000100000000001111111
1011111111111111111111111111111111111111111111000000000011111111111000000000011010010100001111111111
1010000000000000000000000000000000000000000010010100000000000000000001111110000010100101010100000001
1010111111111111111111111111111111111111111010000000000011110000000000101010000000000101010000000111
1010100000000000000000000000000000000000010010000001010111101010101001010000001010101010000000000111
1010101111111111111111111111111111111010010010000000101010100000000000000000000011100000000000000011
1010101000000000000000000000000000010010010010010111111111000000000000000000001010100001111111100011
1010101011111111111111111111111010010010010010010100000001001111110000000000000000000000001111000001
1010101010000000000000000000010010010010000000000000000011111111111111111111111100000000000000011111
1010101010111111111111111110010010010010010010010100010101100000000000001010000000000000011000000001
1010101010100000000000010010010010010010010010010100011111111111100000000000000000000000000000001111
1010101010101111111110010010010010010010010010010111100000000000000001010010101111100000000000000111
1010101010101000000010010010010010010000000000000000000111100000110000000000011010000000001111111111
1010101010101011110010010010010010010010010010010100000011111111111000000001010110101010010101010101
1000000000000000010010010010010010010010010010010100000010111111111111100000011111111111111111000001
0000000000000101111111110000000000000000000111111100000000000010000000000000001111111111111111111101
1000000000000000000000000000000000000000000000000100000000000000000000000000000111111111111000000001
1010101000000000000000000000000000010010010010010111111111000000000000000000001010100001111111100011
1010101011111111111111111111111010010010010010010100000001001111110000000000000000000000001111000001
1111111111111111111111111111111111111111111111111111111111111111111111111111111111111111111111111111






