1111111111111111111111111111111111111111111111111111111111111111111111111111111111111111111111111111
1p00000000000000000000000000000000000000000000000000000000000000000000000000000000000000000000000001
1000000000000000000000000000000000000000000000000000000000000000000000000000000000000000000000000001
1000000000000000000000000000000000000000000000000000000000000000000000000000000000000000000000000001
1000000000000000000000000000000000000000000000000000000000000000000000000000000000000000000000000001
1000000000000000000000000000000000000000000000000000000000000000000000000000000000000000000000000001
1000011111111111111111111111111111111111111111110011111111111111111111111111111111111111111111000001
1000010000000000000000000000000000000000000000000000000000000000000000000000000000000000000001000001
1000010000000000000000000000000000000000000000000000000000000000000000000000000000000000000001000001
1000010000000000000000000000000000000000000000000000000000000000000000000000000000000000000001000001
1000010000000000000000000000000000000000000000000000000000000000000000000000000000000000000001000001
1000010000000000000000000000000000000000000000000000000000000000000000000000000000000000000001000001
1000010000000000000000000000000000000000000000000000000000000000000000000000000000000000000001000001
1000010000000000000000000000000000000000000000000000000000000000000000000000000000000000000001000001
1000010000000000000000000000000000000000000000000000000000000000000000000000000000000000000001000001
1000010000000000000000000000000000000000000000000000000000000000000000000000000000000000000001000001
1000010000000000000000000000000000000000000000000000000000000000000000000000000000000000000001000001
1000010000000000000000000000000000000000000000000000000000000000000000000000000000000000000001000001
1000010000000000000000000000000000000000000000000000000000000000000000000000000000000000000001000001
1000010000000000000000000000000000000000000000000000000000000000000000000000000000000000000001000001
1000010000000000000000000000000000000000000000000000000000000000000000000000000000000000000001000001
1000010000000000000000000000000000000000000000000000000000000000000000000000000000000000000001000001
1000010000000000000000000000000000000000000000000000000000000000000000000000000000000000000001000001
1000010000000000000000000000000000000000000000000000000000000000000000000000000000000000000001000001
1000010000000000000000000000000000000000000000000000000000000000000000000000000000000000000001000001
1000010000000000000000000000000000000000000000000000000000000000000000000000000000000000000001000001
1000010000000000000000000000000000000000000000000000000000000000000000000000000000000000000001000001
1000010000000000000000000000000000000000000000000000000000000000000000000000000000000000000001000001
1000010000000000000000000000000000000000000000000000000000000000000000000000000000000000000001000001
1000010000000000000000000000000000000000000000000000000000000000000000000000000000000000000001000001
1000010000000000000000000000000000000000000000000000000000000000000000000000000000000000000001000001
1000010000000000000000000000000000000000000000000000000000000000000000000000000000000000000001000001
1000010000000000000000000000000000000000000000000000000000000000000000000000000000000000000001000001
1000010000000000000000000000000000000000000000000000000000000000000000000000000000000000000001000001
1000010000000000000000000000000000000000000000000000000000000000000000000000000000000000000001000001
1000010000000000000000000000000000000000000000000000000000000000000000000000000000000000000001000001
1000010000000000000000000000000000000000000000000000000000000000000000000000000000000000000001000001
1000010000000000000000000000000000000000000000000000000000000000000000000000000000000000000001000001
1000010000000000000000000000000000000000000000000000000000000000000000000000000000000000000001000001
1000010000000000000000000000000000000000000000000000000000000000000000000000000000000000000001000001
1000010000000000000000000000000000000000000000000000000000000000000000000000000000000000000001000001
1000010000000000000000000000000000000000000000000000000000000000000000000000000000000000000001000001
1000010000000000000000000000000000000000000000000000000000000000000000000000000000000000000001000001
1000010000000000000000000000000000000000000000000000000000000000000000000000000000000000000001000001
1000010000000000000000000000000000000000000000000000000000000000000000000000000000000000000001000001
1000010000000000000000000000000000000000000000000000000000000000000000000000000000000000000001000001
1000010000000000000000000000000000000000000000000000000000000000000000000000000000000000000001000001
1000010000000000000000000000000000000000000000000000000000000000000000000000000000000000000001000001
1000010000000000000000000000000000000000000000000000000000000000000000000000000000000000000001000001
1000000000000000000000000000000000000000000000000000000000000000000000000000000000000000000000000001
1000000000000000000000000000000000000000000000000000000000000000000000000000000000000000000000000001
1000010000000000000000000000000000000000000000000000000000000000000000000000000000000000000001000001
1000010000000000000000000000000000000000000000000000000000000000000000000000000000000000000001000001
1000010000000000000000000000000000000000000000000000000000000000000000000000000000000000000001000001
1000010000000000000000000000000000000000000000000000000000000000000000000000000000000000000001000001
1000010000000000000000000000000000000000000000000000000000000000000000000000000000000000000001000001
1000010000000000000000000000000000000000000000000000000000000000000000000000000000000000000001000001
1000010000000000000000000000000000000000000000000000000000000000000000000000000000000000000001000001
1000010000000000000000000000000000000000000000000000000000000000000000000000000000000000000001000001
1000010000000000000000000000000000000000000000000000000000000000000000000000000000000000000001000001
1000010000000000000000000000000000000000000000000000000000000000000000000000000000000000000001000001
1000010000000000000000000000000000000000000000000000000000000000000000000000000000000000000001000001
1000010000000000000000000000000000000000000000000000000000000000000000000000000000000000000001000001
1000010000000000000000000000000000000000000000000000000000000000000000000000000000000000000001000001
1000010000000000000000000000000000000000000000000000000000000000000000000000000000000000000001000001
1000010000000000000000000000000000000000000000000000000000000000000000000000000000000000000001000001
1000010000000000000000000000000000000000000000000000000000000000000000000000000000000000000001000001
1000010000000000000000000000000000000000000000000000000000000000000000000000000000000000000001000001
1000010000000000000000000000000000000000000000000000000000000000000000000000000000000000000001000001
1000010000000000000000000000000000000000000000000000000000000000000000000000000000000000000001000001
1000010000000000000000000000000000000000000000000000000000000000000000000000000000000000000001000001
1000010000000000000000000000000000000000000000000000000000000000000000000000000000000000000001000001
1000010000000000000000000000000000000000000000000000000000000000000000000000000000000000000001000001
1000010000000000000000000000000000000000000000000000000000000000000000000000000000000000000001000001
1000010000000000000000000000000000000000000000000000000000000000000000000000000000000000000001000001
1000010000000000000000000000000000000000000000000000000000000000000000000000000000000000000001000001
1000010000000000000000000000000000000000000000000000000000000000000000000000000000000000000001000001
1000010000000000000000000000000000000000000000000000000000000000000000000000000000000000000001000001
1000010000000000000000000000000000000000000000000000000000000000000000000000000000000000000001000001
1000010000000000000000000000000000000000000000000000000000000000000000000000000000000000000001000001
1000010000000000000000000000000000000000000000000000000000000000000000000000000000000000000001000001
1000010000000000000000000000000000000000000000000000000000000000000000000000000000000000000001000001
1000010000000000000000000000000000000000000000000000000000000000000000000000000000000000000001000001
1000010000000000000000000000000000000000000000000000000000000000000000000000000000000000000001000001
1000010000000000000000000000000000000000000000000000000000000000000000000000000000000000000001000001
1000010000000000000000000000000000000000000000000000000000000000000000000000000000000000000001000001
1000010000000000000000000000000000000000000000000000000000000000000000000000000000000000000001000001
1000010000000000000000000000000000000000000000000000000000000000000000000000000000000000000001000001
1000010000000000000000000000000000000000000000000000000000000000000000000000000000000000000001000001
1000010000000000000000000000000000000000000000000000000000000000000000000000000000000000000001000001
1000010000000000000000000000000000000000000000000000000000000000000000000000000000000000000001000001
1000010000000000000000000000000000000000000000000000000000000000000000000000000000000000000001000001
1000010000000000000000000000000000000000000000000000000000000000000000000000000000000000000001000001
1000011111111111111111111111111111111111111111110011111111111111111111111111111111111111111111000001
1000000000000000000000000000000000000000000000000000000000000000000000000000000000000000000000000001
1000000000000000000000000000000000000000000000000000000000000000000000000000000000000000000000000001
1000000000000000000000000000000000000000000000000000000000000000000000000000000000000000000000000001
1000000000000000000000000000000000000000000000000000000000000000000000000000000000000000000000000001
1000000000000000000000000000000000000000000000000000000000000000000000000000000000000000000000000001
1111111111111111111111111111111111111111111111111111111111111111111111111111111111111111111111111111