1111111111111111111111111111111111111111111111111111111111111111111111111111111111111111111111111111
1000000000000000000000000000000000000000000000000000000000000000000000000000000000000000000000000001
1000000000011111111111111111111000000000001111111111111100000011111111111111000000011111111111111001
1110111111000000000000000000001000001111001000000000000000100000010000000000001000000000000000001001
1010100000000000000000000000001000001000001000000001111110101111010111111101000000000000000001111001
1010100011111111111111100000111000001000001000000001000010000001010000000101111111111111111111111001
1010100000000000001000001000000000001000001001111111011111101111011111110100000000000000000000001001
1010100000011111101000001000001111001000001001000001000000001000000000100100001111001111110000001001
1010100111110000101111101111001000001000001001000011111111101111001110100101000001000000000100001001
1010100100000000000000001001001000001001111111000010001000001000001000100100000001000000000100001001
1010100101111000000111001001001000000000000001111010001011101000001000100100000001001111110100001001
1010100100000100110001001001001001111111110000001010001010101111111000100111111100000000010100001001
1010100100000100000001000001001000000000011000000010001000100000000000000100000000000011110100001001
1010100111100101111101000001001000000111011111101010001110111111101110111111001011100001110100001001
1010100000100100000001000001000000000101000000001010001000100000001000000001000000010000000000101001
1010100111100101111111111111111000000101000111011010001110111111101111101111001111100001111100101001
1010100000000100000000000000001000000101000100001010000000100000000000000100000100000000000000001001
1010101111100101111101001111111111101101000100001010111010101111111011110111110100111100111011101001
1010000000100100000001000000000000000001000100000010100010000000000000100100000100000000000100101001
1010111111101111111111001111111111111111001111011110101110111111101110100111000111111111111100101001
1010100000100000000000000000000000000000000000010000100000000000000100000100000000100000000000101001
1010100111111101111111110111111111101111111111011110101110111111101111100111110101111111111100101001
1010100000000000000000000001000000000000000000010000100000000000000100000100000000100000000000101001
1010100011111111111111111111111111111111111111011110101110111111101111100111110101111111111100101001
1010100000000000000000000000000000000000000000010000100000000000000000000100000000100000000000101001
1010101111111111111001111111111111111111111111011111111110111111101110101111100111110111111100101001
1010100000000000001000000000000000000000000000010000000000100000000000000000000000100000000000101001
1010100111111101001111001111111111111101111111010111110101110111111110101111100111111111110100101001
1010100000100000001000000000000000000100000000010000000100100000000000000000000100000000000100101001
1010100110101111001111111111111101101111111111111110110100111111111110100111100111111111100100101001
1010100000100000100000000000000000100100000000010000000100100000000000000000000100000000000100101001
1010100110101111101101111111111100101111111111111110110100111111111110100111101111111111100100101001
1010100000100000000000000000000000000000000000010000000100100000000000000000000000000000000000101001
1010100110101111111111111111111111111111111111111110110100111111111110100111100111111111111100101001
1010100000000000000000000000000000000000000000010000000000000000000000000000000000100000000000101001
1010101111111111111111111111111111111111111111011111111111111111111101111101111100111110111111101001
1010100000000000000000000000000000000000000000010000000000000000000000000000000000100000000000101001
1010101111111111111111111111111111111111111111011111111111111111111101111101111110111111111111101001
1010100000000000000000000000000000000000000000010000000000000000000000000000000000100000000000101001
1010101111111111111111111111111111111111111111011111111111111111111111111111111111111111111101001001
1010100000000000000000000000000000000000000000010000000000000000000000000000000000100000000000101001
1010100000000000000000000000000000000000000000010000000000000000000000000000000000100000000000101001
1010100011111111111111111111111111111111111111011111111111111111111111111111111111111111111101001001
1010100000000000000000000000000000000000000000010000000000000000000000000000000000000000000000000001
1000000000011111111111111111111000000000001111111111111100000011111111111111000000011111111111111001
1110111111000000000000000000001000001111001000000000000000100000010000000000001000000000000000001001
1010100000000000000000000000001000001000001000000001111110101111010111111101000000000000000001111001
1010100011111111111111100000111000001000001000000001000010000001010000000101111111111111111111111001
1010100000000000001000001000000000001000001001111111011111101111011111110100000000000000000000001001
1010100000011111101000001000001111001000001001000001000000001000000000100100001111001111110000001001
1010100111110000101111101111001000001000001001000001111111101111001110100101000001000000000100001001
1010100100000000000000001001001000001001111111000000001000001000001000100100000001000000000100001001
1010100101111000000111001001001000000000000001111000001011101000001000100100000001001111110100001001
1010100100000100110001001001001001111111110000001000001010101111111000100111111100000000010100001001
1010100100000100000001000001001000000000011000000000001000100000000000000100000000000011110100001001
1010100111100101111101000001001000000111011111101000001110111111101110111111001011100001110100001001
1010100000100100000001000001000000000101000000001000001000100000001000000001000000010000000000101001
1010100111100101111111111111111000000101000111011000E01110111111101111101111001111100001111100101001
1010100000000100000000000000001000000101000100001010000000100000000000000100000100000000000000001001
1010101111100101111101001111111111101101000100001010111010101111111011110111110100111100111011101001
1010000000100100000001000000000000000001000100000010100010000000000000100100000100000000000100101001
1010111111101111111111001111111111111111001111011110101110111111101110100111000111111111111100101001
1010100000100000000000000000000000000000000000010000100000000000000100000100000000100000000000101001
1010100111111101111111110111111111101111111111011110101110111111101111100111110101111111111100101001
1010100000000000000000000001000000000000000000010000100000000000000100000100000000100000000000101001
1010100011111111111111111111111111111111111111011110101110111111101111100111110101111111111100101001
1010100000000000000000000000000000000000000000010000100000000000000000000100000000100000000000101001
1010101111111111111001111111111111111111111111011111111110111111101110101111100111110111111100101001
1010100000000000001000000000000000000000000000010000000000100000000000000000000000100000000000101001
1010100111111101001111001111111111111101111111010111110101110111111110101111100111111111110100101001
1010100000100000001000000000000000000100000000010000000100100000000000000000000100000000000100101001
1010100110101111001111111111111101101111111111111110110100111111111110100111100111111111100100101001
1010100000100000100000000000000000100100000000010000000100100000000000000000000100000000000100101001
1010100110101111101101111111111100101111111111111110110100111111111110100111101111111111100100101001
1010100000100000000000000000000000000000000000010000000100100000000000000000000000000000000000101001
1010100110101111111111111111111111111111111111111110110100111111111110100111100111111111111100101001
1010100000000000000000000000000000000000000000010000000000000000000000000000000000100000000000101001
1010101111111111111111111111111111111111111111011111111111111111111101111101111100111110111111101001
1010100000000000000000000000000000000000000000010000000000000000000000000000000000100000000000101001
1010101111111111111111111111111111111111111111011111111111111111111101111101111110111111111111101001
1010100000000000000000000000000000000000000000010000000000000000000000000000000000100000000000101001
1010101111111111111111111111111111111111111111011111111111111111111111111111111111111111111101001001
1010100000000000000000000000000000000000000000010000000000000000000000000000000000100000000000101001
1010100000000000000000000000000000000000000000010000000000000000000000000000000000100000000000101001
1010100000000000000000000000000000000000000000010000000000000000000000000000000000000000000000000001
1010101010101010101010101010101010101010101010101010101010101010101010101010101010101010101010101010
1111101011101110111011101110111010111011101110111010111011101111101111101110111011100001110111010111
1010101010101010101010101010101010101010101010101010101010101010101010101010101010101010101010101010
1011110111011101110111010111011101111101110111011101111101110111010001101110111010111010111011110111
1010101010101010101010101010101010101010101010101010101010101010010110101010101010101010101010101010
1011101111101111101111101111110111011111101110111011101111110111010001101111101111101110111011101111
1010101010101010101010101010101010101010101010101010101010101010101010101010101010101010101010101010
1011111110111010111011101110111010111010111011101110111011101110111000010111010111011101111111110111
1010101010101010101010101010101010101010101010101010101010101010101010101010101010101010101010101010
1000000000000000000000000000000000000000000000000000000000000000000000000000000000000000000000000001
1000000000000000000000000000000000000000000000001000000000000000000000000000000000000000000000000001
1000000000000000000000000000000000000000000000011100000000000000000000000000000000000000000000000001
1000000000000000000000000000000000000000000000000000000000000000000000000000000000000000000000000001
1111111111111111111111111111111111111111111111111111111111111111111111111111111111111111111111111111
