1111111111111111111111111111111111111111111111111111111111111111111111111111111111111111111111111111
1000000000000000000000000000000000000000000000000000000000000000000000000000000000000000000000000001
1000000000000000000000000000000000000000000000000000000000000000000000000000000000000000000000000001
1010101010101010101010101010101010101010101010101010101010101010101010101010101010101010101010101011
1000000000000000000000000000000000000000000000000000000000000000000000000000000000000000000000000001
1000000000000000000000000000000000000000000000000000000000000000000000000000000000000000000000000001
1010101010101010101010101010101010101010101010101010101010101010101010101010101010101010101010101011
1000000000000000000000000000000000000000000000000000000000000000000000000000000000000000000000000001
1000000000000000000000000000000000000000000000000000000000000000000000000000000000000000000000000001
1010101010101010101010101010101010101010101010101010101010101010101010101010101010101010101010101011
1000000000000000000000000000000000000000000000000000000000000000000000000000000000000000000000000001
1000000000000000000000000000000000000000000000000000000000000000000000000000000000000000000000000001
1010101010101010101010101010101010101010101010101010101010101010101010101010101010101010101010101011
1000000000000000000000000000000000000000000000000000000000000000000000000000000000000000000000000001
1000000000000000000000000000000000000000000000000000000000000000000000000000000000000000000000000001
1010101010101010101010101010101010101010101010101010101010101010101010101010101010101010101010101011
1000000000000000000000000000000000000000000000000000000000000000000000000000000000000000000000000001
1000000000000000000000000000000000000000000000000000000000000000000000000000000000000000000000000001
1010101010101010101010101010101010101010101010101010101010101010101010101010101010101010101010101011
1000000000000000000000000000000000000000000000000000000000000000000000000000000000000000000000000001
1000000000000000000000000000000000000000000000000000000000000000000000000000000000000000000000000001
1010101010101010101010101010101010101010101010101010101010101010101010101010101010101010101010101011
1000000000000000000000000000000000000000000000000000000000000000000000000000000000000000000000000001
1000000000000000000000000000000000000000000000000000000000000000000000000000000000000000000000000001
1010101010101010101010101010101010101010101010101010101010101010101010101010101010101010101010101011
1000000000000000000000000000000000000000000000000000000000000000000000000000000000000000000000000001
1000000000000000000000000000000000000000000000000000000000000000000000000000000000000000000000000001
1010101010101010101010101010101010101010101010101010101010101010101010101010101010101010101010101011
1000000000000000000000000000000000000000000000000000000000000000000000000000000000000000000000000001
1000000000000000000000000000000000000000000000000000000000000000000000000000000000000000000000000001
1010101010101010101010101010101010101010101010101010101010101010101010101010101010101010101010101011
1000000000000000000000000000000000000000000000000000000000000000000000000000000000000000000000000001
1000000000000000000000000000000000000000000000000000000000000000000000000000000000000000000000000001
1010101010101010101010101010101010101010101010101010101010101010101010101010101010101010101010101011
1000000000000000000000000000000000000000000000000000000000000000000000000000000000000000000000000001
1000000000000000000000000000000000000000000000000000000000000000000000000000000000000000000000000001
1010101010101010101010101010101010101010101010101010101010101010101010101010101010101010101010101011
1000000000000000000000000000000000000000000000000000000000000000000000000000000000000000000000000001
1000000000000000000000000000000000000000000000000000000000000000000000000000000000000000000000000001
1010101010101010101010101010101010101010101010101010101010101010101010101010101010101010101010101011
1000000000000000000000000000000000000000000000000000000000000000000000000000000000000000000000000001
1000000000000000000000000000000000000000000000000000000000000000000000000000000000000000000000000001
1010101010101010101010101010101010101010101010101010101010101010101010101010101010101010101010101011
1000000000000000000000000000000000000000000000000000000000000000000000000000000000000000000000000001
1000000000000000000000000000000000000000000000000000000000000000000000000000000000000000000000000001
1010101010101010101010101010101010101010101010101010101010101010101010101010101010101010101010101011
1000000000000000000000000000000000000000000000000000000000000000000000000000000000000000000000000001
1000000000000000000000000000000000000000000000000000000000000000000000000000000000000000000000000001
1010101010101010101010101010101010101010101010100000101010101010101010101010101010101010101010101011
100000000000000000000000000000000000000000000100EEE0010000000000000000000000000000000000000000000001
100000000000000000000000000000000000000000000100EEE0010000000000000000000000000000000000000000000001
1010101010101010101010101010101010101010101010100000101010101010101010101010101010101010101010101011
1000000000000000000000000000000000000000000000000000000000000000000000000000000000000000000000000001
1000000000000000000000000000000000000000000000000000000000000000000000000000000000000000000000000001
1010101010101010101010101010101010101010101010101010101010101010101010101010101010101010101010101011
1000000000000000000000000000000000000000000000000000000000000000000000000000000000000000000000000001
1000000000000000000000000000000000000000000000000000000000000000000000000000000000000000000000000001
1010101010101010101010101010101010101010101010101010101010101010101010101010101010101010101010101011
1000000000000000000000000000000000000000000000000000000000000000000000000000000000000000000000000001
1000000000000000000000000000000000000000000000000000000000000000000000000000000000000000000000000001
1010101010101010101010101010101010101010101010101010101010101010101010101010101010101010101010101011
1000000000000000000000000000000000000000000000000000000000000000000000000000000000000000000000000001
1000000000000000000000000000000000000000000000000000000000000000000000000000000000000000000000000001
1010101010101010101010101010101010101010101010101010101010101010101010101010101010101010101010101011
1000000000000000000000000000000000000000000000000000000000000000000000000000000000000000000000000001
1000000000000000000000000000000000000000000000000000000000000000000000000000000000000000000000000001
1010101010101010101010101010101010101010101010101010101010101010101010101010101010101010101010101011
1000000000000000000000000000000000000000000000000000000000000000000000000000000000000000000000000001
1000000000000000000000000000000000000000000000000000000000000000000000000000000000000000000000000001
1010101010101010101010101010101010101010101010101010101010101010101010101010101010101010101010101011
1000000000000000000000000000000000000000000000000000000000000000000000000000000000000000000000000001
1000000000000000000000000000000000000000000000000000000000000000000000000000000000000000000000000001
1010101010101010101010101010101010101010101010101010101010101010101010101010101010101010101010101011
1000000000000000000000000000000000000000000000000000000000000000000000000000000000000000000000000001
1000000000000000000000000000000000000000000000000000000000000000000000000000000000000000000000000001
1010101010101010101010101010101010101010101010101010101010101010101010101010101010101010101010101011
1000000000000000000000000000000000000000000000000000000000000000000000000000000000000000000000000001
1000000000000000000000000000000000000000000000000000000000000000000000000000000000000000000000000001
1010101010101010101010101010101010101010101010101010101010101010101010101010101010101010101010101011
1000000000000000000000000000000000000000000000000000000000000000000000000000000000000000000000000001
1000000000000000000000000000000000000000000000000000000000000000000000000000000000000000000000000001
1010101010101010101010101010101010101010101010101010101010101010101010101010101010101010101010101011
1000000000000000000000000000000000000000000000000000000000000000000000000000000000000000000000000001
1000000000000000000000000000000000000000000000000000000000000000000000000000000000000000000000000001
1010101010101010101010101010101010101010101010101010101010101010101010101010101010101010101010101011
1000000000000000000000000000000000000000000000000000000000000000000000000000000000000000000000000001
1000000000000000000000000000000000000000000000000000000000000000000000000000000000000000000000000001
1010101010101010101010101010101010101010101010101010101010101010101010101010101010101010101010101011
1000000000000000000000000000000000000000000000000000000000000000000000000000000000000000000000000001
1000000000000000000000000000000000000000000000000000000000000000000000000000000000000000000000000001
1010101010101010101010101010101010101010101010101010101010101010101010101010101010101010101010101011
1000000000000000000000000000000000000000000000000000000000000000000000000000000000000000000000000001
1000000000000000000000000000000000000000000000000000000000000000000000000000000000000000000000000001
1010101010101010101010101010101010101010101010101010101010101010101010101010101010101010101010101011
1000000000000000000000000000000000000000000000000000000000000000000000000000000000000000000000000001
1000000000000000000000000000000000000000000000000000000000000000000000000000000000000000000000000001
1010101010101010101010101010101010101010101010101010101010101010101010101010101010101010101010101011
1000000000000000000000000000000000000000000000000000000000000000000000000000000000000000000000000001
1000000000000000000000000000000000000000000000000000000000000000000000000000000000000000000000000001
1111111111111111111111111111111111111111111111111111111111111111111111111111111111111111111111111111