1111111111111111111111111111111111111111111111111111111111111111111111111111111111111111111111111111
1p00000000000000000000000000000000000000010000000111111111111000000000000000000111111111111100001111
1000000111111111110001111111111100011110000100000000000000001111111111000000000000111111100000000011
1000000100000000000000000000000000001000011111111111000000100000011111111000000011110000000001111101
1000000100000000000000000000000000001000010000000000000000001111111111111100000000000000000000011111
1000000000000111111111100001111110010000100011110000000001111000000000001111111111111000000011111111
1000000100000010000000010000100001001000011100000000000011100000011100010000000000000100000001111111
1000000100000010000000010000100001001000011111111000000000000000000000111111111100000000000001110001
1000000000000001000000001000010000100100000000000000000000011111111110000000000000000000000100000001
1000000000000111111111100001111110010000111111000000111111101111111100000000000111100000011100001111
1000000100000000000000000000000000001000010011111000111111111100000000000111111111111000111111000001
1000000111111111111111111111111111111000010000000000111111111111000000110000000000000111000001111001
1000000000000000000000000000000000000000010000011111111110000000011111000000000000000000000000001011
1111100000000011111111000001111111100000000000000001111000000000000000000000000001110000000001110001
1000000000000000000000000000000000000000010000000111111111111000000000000000000111111111111100001111
1000000111111111110001111111111100011110000100000000000000001111111111000000000000111111100000000011
1000000100000000000000000000000000001000011111111111000000100000011111111000000011110000000001111101
1000000100000000000000000000000000001000010000000000000000001111111111111100000000000000000000011111
1000000000000111111111100001111110010000100011110000000001111000000000001111111111111000000011111111
1000000100000010000000010000100001001000011100000000000011100000011100010000000000000100000001111111
1000000100000010000000010000100001001000011111111000000000000000000000111111111100000000000001110001
1000000000000001000000001000010000100100000000000000000000011111111110000000000000000000000100000001
1000000000000111111111100001111110010000111111000000111111101111111100000000000111100000011100001111
1000000100000000000000000000000000001000010011111000111111111100000000000111111111111000111111000001
1000000111111111111111111111111111111000010000000000111111111111000000110000000000000111000001111001
1000000000000000000000000000000000000000010000011111111110000000011111000000000000000000000000001011
1111100000000011111111000001111111100000000000000001111000000000000000000000000001110000000001110001
1000000000000000000000000000000000000000010000000111111111111000000000000000000111111111111100001111
1000000111111111110001111111111100011110000100000000000000001111111111000000000000111111100000000011
1000000100000000000000000000000000001000011111111111000000100000011111111000000011110000000001111101
1000000100000000000000000000000000001000010000000000000000001111111111111100000000000000000000011111
1000000000000111111111100001111110010000100011110000000001111000000000001111111111111000000011111111
1000000100000010000000010000100001001000011100000000000011100000011100010000000000000100000001111111
1000000100000010000000010000100001001000011111111000000000000000000000111111111100000000000001110001
1000000000000001000000001000010000100100000000000000000000011111111110000000000000000000000100000001
1000000000000111111111100001111110010000111111000000111111101111111100000000000111100000011100001111
1000000100000000000000000000000000001000010011111000111111111100000000000111111111111000111111000001
1000000111111111111111111111111111111000010000000000111111111111000000110000000000000111000001111001
1000000000000000000000000000000000000000010000011111111110000000011111000000000000000000000000001011
1111100000000011111111000001111111100000000000000001111000000000000000000000000001110000000001110001
1000000000000000000000000000000000000000010000000111111111111000000000000000000111111111111100001111
1000000111111111110001111111111100011110000100000000000000001111111111000000000000111111100000000011
1000000100000000000000000000000000001000011111111111000000100000011111111000000011110000000001111101
1000000100000000000000000000000000001000010000000000000000001111111111111100000000000000000000011111
1000000000000111111111100001111110010000100011110000000001111000000000001111111111111000000011111111
1000000100000010000000010000100001001000011100000000000011100000011100010000000000000100000001111111
1000000100000010000000010000100001001000011111111000000000000000000000111111111100000000000001110001
1000000000000001000000001000010000100100000000000000000000011111111110000000000000000000000100000001
1000000000000111111111100001111110010000111111000000111111101111111100000000000111100000011100001111
1000000100000000000000000000000000001000010011111000111111111100000000000111111111111000111111000001
1000000111111111111111111111111111111000010000000000111111111111000000110000000000000111000001111001
1000000000000000000000000000000000000000010000011111111110000000011111000000000000000000000000001011
1111100000000011111111000001111111100000000000000001111000000000000000000000000001110000000001110001
1000000000000000000000000000000000000000010000000111111111111000000000000000000111111111111100001111
1000000111111111110001111111111100011110000100000000000000001111111111000000000000111111100000000011
1000000100000000000000000000000000001000011111111111000000100000011111111000000011110000000001111101
1000000100000000000000000000000000001000010000000000000000001111111111111100000000000000000000011111
1000000000000111111111100001111110010000100011110000000001111000000000001111111111111000000011111111
1000000100000010000000010000100001001000011100000000000011100000011100010000000000000100000001111111
1000000100000010000000010000100001001000011111111000000000000000000000111111111100000000000001110001
1000000000000001000000001000010000100100000000000000000000011111111110000000000000000000000100000001
1000000000000111111111100001111110010000111111000000111111101111111100000000000111100000011100001111
1000000100000000000000000000000000001000010011111000111111111100000000000111111111111000111111000001
1000000111111111111111111111111111111000010000000000111111111111000000110000000000000111000001111001
1000000000000000000000000000000000000000010000011111111110000000011111000000000000000000000000001011
1111100000000011111111000001111111100000000000000001111000000000000000000000000001110000000001110001
1000000000000000000000000000000000000000010000000111111111111000000000000000000111111111111100001111
1000000111111111110001111111111100011110000100000000000000001111111111000000000000111111100000000011
1000000100000000000000000000000000001000011111111111000000100000011111111000000011110000000001111101
1000000100000000000000000000000000001000010000000000000000001111111111111100000000000000000000011111
1000000000000111111111100001111110010000100011110000000001111000000000001111111111111000000011111111
1000000100000010000000010000100001001000011100000000000011100000011100010000000000000100000001111111
1000000100000010000000010000100001001000011111111000000000000000000000111111111100000000000001110001
1000000000000001000000001000010000100100000000000000000000011111111110000000000000000000000100000001
1000000000000111111111100001111110010000111111000000111111101111111100000000000111100000011100001111
1000000100000000000000000000000000001000010011111000111111111100000000000111111111111000111111000001
1000000111111111111111111111111111111000010000000000111111111111000000110000000000000111000001111001
1000000000000000000000000000000000000000010000011111111110000000011111000000000000000000000000001011
1111100000000011111111000001111111100000000000000001111000000000000000000000000001110000000001110001
1000000000000000000000000000000000000000010000000111111111111000000000000000000111111111111100001111
1000000111111111110001111111111100011110000100000000000000001111111111000000000000111111100000000011
1000000100000000000000000000000000001000011111111111000000100000011111111000000011110000000001111101
1000000100000000000000000000000000001000010000000000000000001111111111111100000000000000000000011111
1000000000000111111111100001111110010000100011110000000001111000000000001111111111111000000011111111
1000000100000010000000010000100001001000011100000000000011100000011100010000000000000100000001111111
1000000100000010000000010000100001001000011111111000000000000000000000111111111100000000000001110001
1000000000000001000000001000010000100100000000000000000000011111111110000000000000000000000100000001
1000000000000111111111100001111110010000111111000000111111101111111100000000000111100000011100001111
1000000100000000000000000000000000001000010011111000111111111100000000000111111111111000111111000001
1000000111111111111111111111111111111000010000000000111111111111000000110000000000000111000001111001
1000000000000000000000000000000000000000010EEEE01111111111000000001111100000000000000000000000000101
1111100000000011111111000001111111100000000EEEE00001111000000000000000000000000001110000000001110001
1000000000000000000000000000000000000000010000000111111111111000000000000000000111111111111100001111
1000000111111111110001111111111100011110000100000000000000001111111111000000000000111111100000000011
1000000100000000000000000000000000001000011111111111000000100000011111111000000011110000000001111101
1000000100000000000000000000000000001000010000000000000000001111111111111100000000000000000000011111
1000000000000111111111100001111110010000100011110000000001111000000000001111111111111000000011111111
1000000100000010000000010000100001001000011100000000000011100000011100010000000000000100000001111111
1000000100000010000000010000100001001000011111111000000000000000000000111111111100000000000001110001
1111111111111111111111111111111111111111111111111111111111111111111111111111111111111111111111111111






