1111111111111111111111111111111111111111111111111111111111111111111111111111111111111111111111111111
10p0111111111111111111111111111111111111111111111111111111111111111111111111111111111111111111111111
1000000000000000000000000000000000000000000001111000000000000000000111100000000011100000000000000001
1000011111111111100000000000000000001111110000000000000000111100000001111001110000111000000000000011
1000011000000000001111111111111111111000001001111111100000000000000000000011111110000001110000001111
1000011000000000000001111000000000000000010000000000011111000000001111000000000111110000000000000001
1110000110000000000000000000011110011111000100011000000000111111111000000000000000000000111000011111
1111100001100000011110111100000000000000001110011000000000000000000111110000000000011000111000000001
1111110000110000111000000000001111100000000000000000111111111100000000001110000000110011100000111001
1111100111000000000100000000000000000111110001111100111000000001111000000001101111000000000111100001
1111000111000000011000011111100000000000000000000000011100000100000111100000010000000000000001100001
1000010000111000110000110000001100000000000000000000111000011010000000011110000000000000001110011001
1000011000000011000000110000000011000000111110011100000000011100000000000011000000000000111000001001
1000011100000011000000001000011111000110000000000011000000111000010000000000011110000000111000000101
1000000111000110000001100000000111000011001111111000001111000000001000000111000001100011100000000111
1000111000001110000001111111110000011110001100000000111100000111110000100010000000000011100000000001
1000000011111111000001100110000000000011100000000111111111000000000000000101100001111000000000000001
1001111100000111111000001111100000000111110000000000000001111100001111111000000000000011111000000011
1000000000000000000000000000000000000000000001111000000000000000000111100000000011100000000000000001
1000011111111111100000000000000000001111110000000000000000111100000001111001110000111000000000000011
1000011000000000001111111111111111111000001001111111100000000000000000000011111110000001110000001111
1000011000000000000001111000000000000000010000000000011111000000001111000000000111110000000000000001
1110000110000000000000000000011110011111000100011000000000111111111000000000000000000000111000011111
1111100001100000011110111100000000000000001110011000000000000000000111110000000000011000111000000001
1111110000110000111000000000001111100000000000000000111111111100000000001110000000110011100000111001
1111100111000000000100000000000000000111110001111100111000000001111000000001101111000000000111100001
1111000111000000011000011111100000000000000000000000011100000100000111100000010000000000000001100001
1000010000111000110000110000001100000000000000000000111000011010000000011110000000000000001110011001
1000011000000011000000110000000011000000111110011100000000011100000000000011000000000000111000001001
1000011100000011000000001000011111000110000000000011000000111000010000000000011110000000111000000101
1000000111000110000001100000000111000011001111111000001111000000001000000111000001100011100000000111
1000111000001110000001111111110000011110001100000000111100000111110000100010000000000011100000000001
1000000011111111000001100110000000000011100000000111111111000000000000000101100001111000000000000001
1001111100000111111000001111100000000111110000000000000001111100001111111000000000000011111000000011
1000000000000000000000000000000000000000000001111000000000000000000111100000000011100000000000000001
1000011111111111100000000000000000001111110000000000000000111100000001111001110000111000000000000011
1000011000000000001111111111111111111000001001111111100000000000000000000011111110000001110000001111
1000011000000000000001111000000000000000010000000000011111000000001111000000000111110000000000000001
1110000110000000000000000000011110011111000100011000000000111111111000000000000000000000111000011111
1111100001100000011110111100000000000000001110011000000000000000000111110000000000011000111000000001
1111110000110000111000000000001111100000000000000000111111111100000000001110000000110011100000111001
1111100111000000000100000000000000000111110001111100111000000001111000000001101111000000000111100001
1111000111000000011000011111100000000000000000000000011100000100000111100000010000000000000001100001
1000010000111000110000110000001100000000000000000000111000011010000000011110000000000000001110011001
1000011000000011000000110000000011000000111110011100000000011100000000000011000000000000111000001001
1000011100000011000000001000011111000110000000000011000000111000010000000000011110000000111000000101
1000000111000110000001100000000111000011001111111000001111000000001000000111000001100011100000000111
1000111000001110000001111111110000011110001100000000111100000111110000100010000000000011100000000001
1000000011111111000001100110000000000011100000000111111111000000000000000101100001111000000000000001
1001111100000111111000001111100000000111110000000000000001111100001111111000000000000011111000000011
1000000000000000000000000000000000000000000001111000000000000000000111100000000011100000000000000001
1000011111111111100000000000000000001111110000000000000000111100000001111001110000111000000000000011
1000011000000000001111111111111111111000001001111111100000000000000000000011111110000001110000001111
1000011000000000000001111000000000000000010000000000011111000000001111000000000111110000000000000001
1110000110000000000000000000011110011111000100011000000000111111111000000000000000000000111000011111
1111100001100000011110111100000000000000001110011000000000000000000111110000000000011000111000000001
1111110000110000111000000000001111100000000000000000111111111100000000001110000000110011100000111001
1111100111000000000100000000000000000111110001111100111000000001111000000001101111000000000111100001
1111000111000000011000011111100000000000000000000000011100000100000111100000010000000000000001100001
1000010000111000110000110000001100000000000000000000111000011010000000011110000000000000001110011001
1000011000000011000000110000000011000000111110011100000000011100000000000011000000000000111000001001
1000011100000011000000001000011111000110000000000011000000111000010000000000011110000000111000000101
1000000111000110000001100000000111000011001111111000001111000000001000000111000001100011100000000111
1000111000001110000001111111110000011110001100000000111100000111110000100010000000000011100000000001
1000000011111111000001100110000000000011100000000111111111000000000000000101100001111000000000000001
1001111100000111111000001111100000000111110000000000000001111100001111111000000000000011111000000011
1000000000000000000000000000000000000000000001111000000000000000000111100000000011100000000000000001
1000011111111111100000000000000000001111110000000000000000111100000001111001110000111000000000000011
1000011000000000001111111111111111111000001001111111100000000000000000000011111110000001110000001111
1000011000000000000001111000000000000000010000000000011111000000001111000000000111110000000000000001
1110000110000000000000000000011110011111000100011000000000111111111000000000000000000000111000011111
1111100001100000011110111100000000000000001110011000000000000000000111110000000000011000111000000001
1111110000110000111000000000001111100000000000000000111111111100000000001110000000110011100000111001
1111100111000000000100000000000000000111110001111100111000000001111000000001101111000000000111100001
1111000111000000011000011111100000000000000000000000011100000100000111100000010000000000000001100001
1000010000111000110000110000001100000000000000000000111000011010000000011110000000000000001110011001
1000011000000011000000110000000011000000111110011100000000011100000000000011000000000000111000001001
1000011100000011000000001000011111000110000000000011000000111000010000000000011110000000111000000101
1000000111000110000001100000000111000011001111111000001111000000001000000111000001100011100000000111
1000111000001110000001111111110000011110001100000000111100000111110000100010000000000011100000000001
1000000011111111000001100110000000000011100000000111111111000000000000000101100001111000000000000001
1001111100000111111000001111100000000111110000000000000001111100001111111000000000000011111000000011
1000000000000000000000000000000000000000000001111000000000000000000111100000000011100000000000000001
1000011111111111100000000000000000001111110000000000000000111100000001111001110000111000000000000011
1000011000000000001111111111111111111000001001111111100000000000000000000011111110000001110000001111
1000011000000000000001111000000000000000010000000000011111000000001111000000000111110000000000000001
1110000110000000000000000000011110011111000100011000000000111111111000000000000000000000111000011111
1111100001100000011110111100000000000000001110011000000000000000000111110000000000011000111000000001
1111110000110000111000000000001111100000000000000000111111111100000000001110000000110011100000111001
1111100111000000000100000000000000000111110001111100111000000001111000000001101111000000000111100001
1111000111000000011000011111100000000000000000000000011100000100000111100000010000000000000001100001
1000010000111000110000110000001100000000000000000000111000011010000000011110000000000000001110011001
1000011000000011000000110000000011000000111110011100000000011100000000000011000000000000111000001001
1000011100000011000000001000011111000110000000000011000000111000010000000000011110000000111000000101
1000000111000110000001100000000111000011001111111000001111000000001000000111000001100011100000000111
1000111000001110000001111111110000011110001100000000111100000111110000100010000000000011100000000001
1000000011111111000001100110000000000011100000000111111111000000000000000101100001111000000000000001
1001111111111111110011111111100011111111110001111111111111111111001111111011110000000001111111111111
1000000000000000000000000000000000000000000000000000000000000000000000000000000000000000000000000EE1
1111111111111111111111111111111111111111111111111111111111111111111111111111111111111111111111111111






