1111111111111111111111111111111111111111111111111111111111111111111111111111111111111111111111111111
1p00000000000000000110000000000000000000000000000000000001100000000000000000000000000000000000011001
1000000000000000011001100000000000000000000000000000000110011000000000000000000000000000000001100101
1000000000000001100000011000000000000000000000000000011000000110000000000000000000000000000110000001
1000000000000110000000000110000000000000000000000001100000000001100000000000000000000000011000000001
1000000000000000000000000001100000000000000000000110000000000000011000000000000000000001100000000001
1000000000000000000000000000011000000000000000011000000000000000000110000000000000000110000000000001
1000000110000000000000000000000110000000000001100000000000000000000001100000000000011000000000000001
1000011000000000000000000000000001100000000110000000000000000000000000011000000001100000000000000001
1001100000000000000000000000000000011000011000000000000000000000000000000110000110000000000000000001
1110000000000000000000000000000000000000000000000000000000000000000000000000000000000000000000000001
1110000000000000000000000000000000000000000000000000000000000000000000000000001000000000000000000001
1001100000000000000000000000000000011000011000000000000000000000000000000110000110000000000000000001
1000011000000000000000000000000001100000000110000000000000000000000000011000000001100000000000000001
1000000110000000000000000000001110000000000001100000000000000000000011000000000000110000000000000001
1000000011000000000000000000110000000000000000110000000000000000001100000000000000001100000000000001
1000000000110000000000000011000000000000000000001100000000000000110000000000000000000011000000000001
1000000000001100000000001100000000000000000000000011000000000011000000000000000000000000110000000001
1000000000000011000000110000000000000000000000000000110000001100000000000000000000000000001100000001
1000000000000000110011000000000000000000000000000000001100110000000000000000000000000000000011000001
1000000000000000000000000000000000000000000000000000001100000000000000000000000000000000000000110001
1000000000000000000000000000000000000000000000000000001100000000000000000000000000000000000000011001
1000000000000000011001100000000000000000000000000000001110011000000000000000000000000000000001100101
1000000000000001100000011000000000000000000000000000011000000110000000000000000000000000000110000001
1000000000000110000000000110000000000000000000000001100000000001100000000000000000000000011000000001
1000000000011000000000000001100000000000000000000110000000000000011000000000000000000001100000000001
1000000001100000000000000000011000000000000000011000000000000000000110000000000000000110000000000001
1000000110000000000000000000000110000000000001100000000000000000000001100000000000011000000000000001
1000011000000000000000000000000001100000000110000000000000000000000000011000000001100000000000000001
1001100000000000000000000000000000011000011000000000000000000000000000000110000110000000000000000001
1110000000000000000000000000000000000111100000000000000000000000000000000001111000000000000000000001
1110000000000000000000000000000000000111100000000000000000000000000000000001111000000000000000000001
1001100000000000000000000000000000011000011000000000000000000000000000000110000110000000000000000001
1100011000000000000000000000000001100000000110000000000000000000000000011000000001100000000000000001
1000000110000000000000000000001110000000000001100000000000000000000001100000000000011000000000000001
1000000011000000000000000000110000000000000000110000000000000000001100000000000000001100000000000001
1000000000110000000000000011000000000000000000001100000000000000110000000000000000000011000000000001
1000000000001100000000001100000000000000000000000011000000000011000000000000000000000000110000000001
1000000000000011000000110000000000000000000000000000110000001100000000000000000000000000001100000001
1000000000000000110011000000000000000000000000000000001100110000000000000000000000000000000011000001
1000000000000000001100000000000000000000000000000000000110000000000000000000000000000000000000000001
1000000000000000001100000000000000000000000000000000000111100000000000000000000000000000000000000001
1000000000000000011001100000000000000000000000000000000110011000000000000000000000000000000001100101
1000000000000001100000011000000000000000000000000000011000000110000000000000000000000000000110000001
1000000000000110000000000110000000000000000000000001100000000001100000000000000000000000011000000001
1000000000011000000000000001100000000000000000000110000000000000011000000000000000000001100000000001
1000000001100000000000000000011000000000000000011000000000000000000110000000000000000110000000000001
1000000110000000000000000000000110000000000001100000000000000000000001100000000000011000000000000001
1000011000000000000000000000000001100000000110000000000100001000000000011000000001100000000000000001
1001100000000000000000000000000000011000011000000000000000000000000000000110000110000000000000000001
111000000000000000000000000000000000000000000000000000000EE00000000000000110000000000000000000000001
111000000000000000000000000000000000000000000000000000000EE00000000000000110000000000000000000000001
1001100000000000000000000000000000011000011000000000000000000000000000000110000110000000000000000001
1100011000000000000000000000000001100000000110000000000100001000000000110000000001100000000000000001
1000000110000000000000000000001100000000000001100000000000000000000011000000000000011000000000000001
1000000011000000000000000000110000000000000000110000000000000000001100000000000000001100000000000001
1000000000110000000000000011000000000000000000001100000000000000110000000000000000000011000000000001
1000000000001100000000001100000000000000000000000011000000000011000000000000000000000000110000000001
1000000000000011000000110000000000000000000000000000110000001100000000000000000000000000001100000001
1000000000000000110011000000000000000000000000000000001100110000000000000000000000000000000011000001
1000000000000000000000000000000000000000000000000000000000000000000000000000000000000000000000110001
1000000000000000000000000000000000000000000000000000000000000000000000000000000000000000000000011001
1000000000000000011011000000000000000000000000000000000110011000000000000000000000000000000001100101
1000000000000001100000011000000000000000000000000000011000000110000000000000000000000000000110000001
1000000000000110000000000110000000000000000000000001100000000001100000000000000000000000011000000001
1000000000011000000000000001100000000000000000000110000000000000011000000000000000000001100000000001
1000000001100000000000000000011000000000000000011000000000000000000110000000000000000110000000000001
1000000110000000000000000000000110000000000001100000000000000000000001100000000000011000000000000001
1000011000000000000000000000000001100000000110000000000000000000000000011000000001100000000000000001
1001100000000000000000000000000000011000011000000000000000000000000000000110000110000000000000000001
1110000000000000000000000000000000000000000000000000000000000000000000000001111000000000000000000001
1110000000000000000000000000000000000000000000000000000000000000000000000001111000000000000000000001
1001100000000000000000000000000000011000011000000000000000000000000000000110000110000000000000000001
0100011000000000000000000000000001100000000110000000000000000000000000011000000001100000000000000001
1000000110000000000000000000000110000000000001100000000000000000000001100000000000011000000000000001
1000000011000000000000000000110000000000000000110000000000000000001100000000000000001100000000000001
1000000000110000000000000011000000000000000000001100000000000000110000000000000000000011000000000001
1000000000001100000000001100000000000000000000000011000000000011000000000000000000000000110000000001
1000000000000011000000110000000000000000000000000000110000001100000000000000000000000000001100000001
1000000000000000110011000000000000000000000000000000001100110000000000000000000000000000000011000001
1000000000000000001100000000000000000000000000000000000000000000000000000000000000000000000000110001
1000000000000000001100000000000000000000000000000000000000000000000000000000000000000000000000011001
1000000000000000011001100000000000000000000000000000000110011000000000000000000000000000000001100101
1000000000000001100000011000000000000000000000000000011000000110000000000000000000000000000110000011
1000000000000110000000000110000000000000000000000001100000000001100000000000000000000000011000000001
1000000000011000000000000001100000000000000000000110000000000000011000000000000000000001100000000001
1000000001100000000000000000011000000000000000011000000000000000000110000000000000000110000000000001
1000000110000000000000000000000110000000000001100000000000000000000001100000000000011000000000000001
1000011000000000000000000000000001100000000110000000000000000000000000011000000001100000000000000001
1001100000000000000000000000000000011000011000000000000000000000000000000110000110000000000000000001
1110000000000000000000000000000000000111100000000000000000000000000000000000000000000000000000000001
1110000000000000000000000000000000000111100000000000000000000000000000000000000000000000000000000001
1001100000000000000000000000000000011000011000000000000000000000000000000110000110000000000000000001
1000011000000000000000000000000001100000000110000000000000000000000000011000000001100000000000000001
1000000110000000000000000000000110000000000001100000000000000000000001100000000000011000000000000001
1000000011000000000000000000110000000000000000110000000000000000001100000000000000001100000000000001
1000000000110000000000000011000000000000000000001100000000000000110000000000000000000011000000000001
1000000000001100000000001100000000000000000000000011000000000011000000000000000000000000110000000001
1000000000000011000000110000000000000000000000000000110000001100000000000000000000000000001100000001
1111111111111111111111111111111111111111111111111111111111111111111111111111111111111111111111111111
