11111111111111111111111111111111111111111111111111111111111111111111111111111111
10000000000000000000000000000000000000000000000000000000000000000000000000000001
10000000000000000000000000000000000000000000000000000000000000000000000000000001
10000000000000000000000000000000000000000000000000000000000000000000000000000001
10000000000000000000000000000000000000000000000000000000000000000000000000000001
10000011111111111111111111111111111111111111111111111111111111111111111111000001
10000010000000000000000000000000000000000000000000000000000000000000000001000001
10000010000000000000000000000000000000000000000000000000000000000000000001000001
10000010000000000000000000000000000000100000000000000000000000000000000001000001
10000010000000000000000000000000000000100000000000000000000000000000000001000001
10000010000000000000000000000000000000100000000000000000000000000000000001000001
10000010000000000000000000000000000000100000000000000000000000000000000001000001
10000010000000000000000000000000000000100000000000000000000000000000000001000001
10000010000000000000000000000000000000100000000000000000000000000000000001000001
10000010000000000000000000000000000000100000000000000000000000000000000001000001
10000010000000000000000000000000000000100000000000000000000000000000000001000001
10000010000000000000000000000000000000100000000000000000000000000000000001000001
10000010000000000000000000000000000000100000000000000000000000000000000001000001
10000010000000000000000000000000000000100000000000000000000000000000000001000001
10000010000000000000000000000000000000100000000000000000000000000000000001000001
10000010000000000000000000000000000000100000000000000000000000000000000001000001
10000010000000000000000000000000000000100000000000000000000000000000000001000001
10000010000000000000000000000000000000100000000000000000000000000000000001000001
10000010000000000000000000000000000000100000000000000000000000000000000001000001
10000010000000000000000000000000000000100000000000000000000000000000000001000001
10000010000000000000000000000000000000100000000000000000000000000000000001000001
10000010000000000000000000000000000000000000000000000000000000000000000001000001
10000010001111111111111111111111111110001111111111111111111111111111110001000001
10000010000000000000000000000000000000000000000000000000000000000000000001000001
10000010000000000000000000000000000000100000000000000000000000000000000001000001
10000010000000000000000000000000000000100000000000000000000000000000000001000001
10000010000000000000000000000000000000100000000000000000000000000000000001000001
10000010000000000000000000000000000000100000000000000000000000000000000001000001
10000010000000000000000000000000000000100000000000000000000000000000000001000001
10000010000000000000000000000000000000100000000000000000000000000000000001000001
10000010000000000000000000000000000000100000000000000000000000000000000001000001
10000010000000000000000000000000000000100000000000000000000000000000000001000001
10000010000000000000000000000000000000100000000000000000000000000000000001000001
10000010000000000000000000000000000000100000000000000000000000000000000001000001
10000010000000000000000000000000000000100000000000000000000000000000000001000001
10000010000000000000000000000000000000100000000000000000000000000000000001000001
10000010000000000000000000000000000000100000000000000000000000000000000001000001
10000010000000000000000000000000000000100000000000000000000000000000000001000001
10000010000000000000000000000000000000100000000000000000000000000000000001000001
10000010000000000000000000000000000000100000000000000000000000000000000001000001
10000010000000000000000000000000000000100000000000000000000000000000000001000001
10000010000000000000000000000000000000100000000000000000000000000000000001000001
10000010000000000000000000000000000000100000000000000000000000000000000001000001
10000010000000000000000000000000000000100000000000000000000000000000000001000001
10000010000000000000000000000000000000100000000000000000000000000000000001000001
10000010000000000000000000000000000000100000000000000000000000000000000001000001
10000010000000000000000000000000000000000000000000000000000000000000000001000001
10000010000000000000000000000000000000000000000000000000000000000000000001000001
10000011111111111111111111111111111100000111111111111111111111111111111111000001
10000000000000000000000000000000000000000000000000000000000000000000000000000001
10000000000000000000000000000000000000000000000000000000000000000000000000000001
10000000000000000000000000000000000000000000000000000000000000000000000000000001
10000000000000000000000000000000000000000000000000000000000000000000000000000001
10000000000000000000000000000000000000000000000000000000000000000000000000000001
11111111111111111111111111111111111111111111111111111111111111111111111111111111
