1111111111111111111111111111111111111111111111111111111111111111111111111111111111111111111111111111
1p00000000000000000000000000000000000000000000000000000000000000000000000000000000000000000000000001
1111111111111111111111111111111111111111111111111111111111111001111111111111111111111111111111111111
1000000000000000000000000000000000000000000000000000000000000000111111111111111111111111111111111111
1111111111110000100000000000000000000000000000000000000000000011111111111111111111111111111111111111
1000000000000001111111111111111111111110011111111111100111111111111111111111111111111111111111111111
1001110111111110000000000000000000000000000000000000001001000100000000100000000000000000000000000001
1000000000000000000000000111100000000000011111000001001010011111100100000000001111111110001111111001
1011111100001111111000000000000011111100000000000000100110100000010010000011110000000001000000000111
1001111000000111000000001111000000011111100011111110010000100000010001111100000000000011000000000111
1000111100000000000001111000000000000000000000000000000000011111000000100000000000000000111000111111
1011100000111000011000000000000111111000000000000001111111111000000100000111110000000111000000011111
1000000000111100000111110110011111111111110000000000000000000000000000000001000011111111000000000001
1100111111000000000000000111100001111111111100011111111111110000001111100000000100001000001111110001
1000000011111111111000000111110000001111111000000000000000000000000000000000000100100000000000000001
1000000111111100000011111100000000000000000011111001100001111111100000000010001111111000000000000001
1011111000000000000000000000000000111111000000000000000111111000001111110011110000010000000001100001
1000000000000001111111100000111100000000000001111110000000000000111111110000100000001110000000000001
1001111110000000000001111110000000001111111000000000111111110000000000001000000111111100000000000001
1000000000011111111000000000000111111110000000000000000000111111111111000000000000100001111111000001
1000000000000000000000000000000000000000000000000000000000000000000000000000000000000000000000000001
1111111110011110011111100011111111111000001111111111111111111100000000000001111011110101111110011111
1000000000000000000000000000000000000000000000000000000000000000000000000111111011110101111111011111
1111111111110000100000000000000000000000000000000000000000000011111111111111111001110001111111000001
1000000000000001111111111111111111111110011111111111100111111111111111111111111100000001111111111101
1001110111111110000000000000000000000000000000000000001001000100000000100000001111000000000000000001
1000000000000000000000000111100000000000011111000001001010011111100100000000001111111110001111111001
1011111100001111111000000000000011111100000000000000100110100000010010000011110000000001000000000111
1001111000000111000000001111000000011111100011111110010000100000010001111100000000000011000000000111
1000111100000000000001111000000000000000000000000000000000011111000000100000000000000000111000111111
1011100000111000011000000000000111111000000000000001111111111000000100000111110000000111000000011111
1000000000111100000111110110011111111111110000000000000000000000000000000001000011111111000000000001
1100111111000000000000000111100001111111111100011111111111110000001111100000000100001000001111110001
1000000011111111111000000111110000001111111000000000000000000000000000000000000100100000000000000001
1000000111111100000011111100000000000000000011111001100001111111100000000010001111111000000000000001
1011111000000000000000000000000000111111000000000000000111111000001111110011110000010000000001100001
1000000000000001111111100000111100000000000001111110000000000000111111110000100000001110000000000001
1001111110000000000001111110000000001111111000000000111111110000000000001000000111111100000000000001
1000000000011111111000000000000111111110000000000000000000111111111111000000000000100001111111000001
1000000000000000000000000000000000000000000000000000000000000000000000000000000000000000000000000001
1110011111111111011100011111111111000011111111111111111111110011101111000111111110001111111111111111
1000000000000000111110111000000000110000111100000000000000000011001111110001111110001011111111111111
1111111111110000100000000000000000111110000000000000000000000111101111111110001111110001111111111111
1000000000000001111111111111111111111110011111111111100111111111110111111111100011111110011111111111
1001110111111110000000000000000000000000000000000000001001000100000000100000000000000000000000000001
1000000000000000000000000111100000000000011111000001001010011111100100000000001111111110001111111001
1011111100001111111000000000000011111100000000000000100110100000010010000011110000000001000000000111
1001111000000111000000001111000000011111100011111110010000100000010001111100000000000011000000000111
1000111100000000000001111000000000000000000000000000000000011111000000100000000000000000111000111111
1011100000111000011000000000000111111000000000000001111111111000000100000111110000000111000000011111
1000000000111100000111110110011111111111110000000000000000000000000000000001000011111111000000000001
1100111111000000000000000111100001111111111100011111111111110000001111100000000100001000001111110001
1000000011111111111000000111110000001111111000000000000000000000000000000000000100100000000000000001
1000000111111100000011111100000000000000000011111001100001111111100000000010001111111000000000000001
1011111000000000000000000000000000111111000000000000000111111000001111110011110000010000000001100001
1000000000000001111111100000111100000000000001111110000000000000111111110000100000001110000000000001
1001111110000000000001111110000000001111111000000000111111110000000000001000000111111100000000000001
1000000000011111111000000000000111111110000000000000000000111111111111000000000000100001111111000001
1000000000000000000000000000000000000000000000000000000000000000000000000000000000000000000000000001
1111111110011110011111100011111111111000001111111111111111111100000000000001111011110101111110011111
1000000000000000000000000000000000000000000000000000000000000000000000000111111011110101111111011111
1111111111110000100000000000000000000000000000000000000000000011111111111111111001110001111111000001
1000000000000001111111111111111111111110011111111111100111111111111111111111111100000001111111111101
1001110111111110000000000000000000000000000000000000001001000100000000100000001111000000000000000001
1000000000000000000000000111100000000000011111000001001010011111100100000000001111111110001111111001
1011111100001111111000000000000011111100000000000000100110100000010010000011110000000001000000000111
1001111000000111000000001111000000011111100011111110010000100000010001111100000000000011000000000111
1000111100000000000001111000000000000000000000000000000000011111000000100000000000000000111000111111
1011100000111000011000000000000111111000000000000001111111111000000100000111110000000111000000011111
1000000000111100000111110110011111111111110000000000000000000000000000000001000011111111000000000001
1100111111000000000000000111100001111111111100011111111111110000001111100000000100001000001111110001
1000000011111111111000000111110000001111111000000000000000000000000000000000000100100000000000000001
1000000111111100000011111100000000000000000011111001100001111111100000000010001111111000000000000001
1011111000000000000000000000000000111111000000000000000111111000001111110011110000010000000001100001
1000000000000001111111100000111100000000000001111110000000000000111111110000100000001110000000000001
1001111110000000000001111110000000001111111000000000111111110000000000001000000111111100000000000001
1000000000011111111000000000000111111110000000000000000000111111111111000000000000100001111111000001
1000000000000000000000000000000000000000000000000000000000000000000000000000000000000000000000000001
1111111111111111111111111111111111111111111111111111111111111001111111111111111111111111111111111111
1111111111100000000000000000000000000011111111111111111111111000111111111111111111111111111111111111
1111111111110000111111111111111111110000000000000000000000000011111111111111111111111111111111111111
1000000000000001111111111111111111111110011111111111100111111111111111111111111111111111111111111111
1001110111111100000000000000000000000000000000000000001001000100000000100000000000000000000000000001
1000000000000000000000000111100000000000011111000001001010011111100100000000001111111110001111111001
1011111100001111111000000000000011111100000000000000100110100000010010000011110000000001000000000111
1001111000000111000000001111000000011111100011111110010000100000010001111100000000000011000000000111
1000111100000000000001111000000000000000000000000000000000011111000000100000000000000000111000111111
1011100000111000011000000000000111111000000000000001111111111000000100000111110000000111000000011111
1000000000111100000111110110011111111111110000000000000000000000000000000001000011111111000000000001
1100111111000000000000000111100001111111111100011111111111110000001111100000000100001000001111110001
1000000011111111111000000111110000001111111000000000000000000000000EEE000000000100100000000000000001
1000000111111100000011111100000000000000000011111001100001111111100EEE000010001111111000000000000001
1011111000000000000000000000000000111111000000000000000111111000001111110011110000010000000001100001
1000000000000001111111100000111100000000000001111110000000000000111111110000100000001110000000000001
1001111110000000000001111110000000001111111000000000111111110000000000001000000111111100000000000001
1000000000011111111000000000000111111110000000000000000000111111111111000000000000100001111111000001
1000000000000000000000000000000000000000000000000000000000000000000000000000000000000000000000000001
1111111110011110011111100011111111111000001111111111111111111100000000000001111011110101111110011111
1000000000000000000000000000000000000000000000000000000000000000000000000111111011110101111111011111
1111111111111111111111111111111111111111111111111111111111111111111111111111111111111111111111111111






