1111111111111111111111111111111111111111111111111111111111111111111111111111111111111111111111111111
1p00000000000000000000000000000000000000000000000000000000000000000000000000000000000000000000000001
1000000000000000000000000000000000000000000000000000000000000000000000000000000000000000000000000001
1000000000000000000000000000000000000000000000000000000000000000000000000000000000000000000000000001
1000000000000000000000000000000000000000000000000000000000000000000000000000000000000000000000000001
1000000000000000000000000000000000000000000000000000000000000000000000000000000000000000000000000001
1000011111111111111111111111111111111111111111110011111111111111111111111111111111111111111111000001
1000010000000000000000000000000000000000000000000000000000000000000000000000000000000000000001000001
1000010000000000000000000000000000000000000000000000000000000000000000000000000000000000000001000001
1000010000000000000000000000000000000000000000000000000000000000000000000000000000000000000001000001
1000010000000000000000000000000000000000000000000000000000000000000000000000000000000000000001000001
1000010000000000000000000000000000000000000000000000000000000000000000000000000000000000000001000001
1000010000011111111111111111111111111111111111111111111111111111111111111111111111111111000001000001
1000010000010000000000000000000000000000000000000000000000000000000000000000000000000001000001000001
1000010000010000000000000000000000000000000000000000000000000000000000000000000000000001000001000001
1000010000010000000000000000000000000000000000000000000000000000000000000000000000000001000001000001
1000010000010000000000000000000000000000000000000000000000000000000000000000000000000001000001000001
1000010000010000000000000000000000000000000000000000000000000000000000000000000000000001000001000001
1000010000010000011111111111111111111111111111110011111111111111111111111111111111000001000001000001
1000010000010000010000000000000000000000000000000000000000000000000000000000000001000001000001000001
1000010000010000010000000000000000000000000000000000000000000000000000000000000001000001000001000001
1000010000010000010000000000000000000000000000000000000000000000000000000000000001000001000001000001
1000010000010000010000000000000000000000000000000000000000000000000000000000000001000001000001000001
1000010000010000010000000000000000000000000000000000000000000000000000000000000001000001000001000001
1000010000010000010000011111111111111111111111111111111111111111111111111111000001000001000001000001
1000010000010000010000010000000000000000000000000000000000000000000000000001000001000001000001000001
1000010000010000010000010000000000000000000000000000000000000000000000000001000001000001000001000001
1000010000010000010000010000000000000000000000000000000000000000000000000001000001000001000001000001
1000010000010000010000010000000000000000000000000000000000000000000000000001000001000001000001000001
1000010000010000010000010000000000000000000000000000000000000000000000000001000001000001000001000001
1000010000010000010000010000000000000000000000000000000000000000000000000001000001000001000001000001
1000010000010000010000010000000000000000000000000000000000000000000000000001000001000001000001000001
1000010000010000010000010000000000000000000000000000000000000000000000000001000001000001000001000001
1000010000010000010000010000000000000000000000000000000000000000000000000001000001000001000001000001
1000010000010000010000010000000000000000000000000000000000000000000000000001000001000001000001000001
1000010000010000010000010000000000000000000000000000000000000000000000000001000001000001000001000001
1000010000010000010000010000000000000000000000000000000000000000000000000001000001000001000001000001
1000010000010000010000010000000000000000000000000000000000000000000000000001000001000001000001000001
1000010000010000010000010000000000000000000000000000000000000000000000000001000001000001000001000001
1000010000010000010000010000000000000000000000000000000000000000000000000001000001000001000001000001
1000010000010000010000010000000000000000000000000000000000000000000000000001000001000001000001000001
1000010000010000010000010000000000000000000000000000000000000000000000000001000001000001000001000001
1000010000010000010000010000000000000000000000000000000000000000000000000001000001000001000001000001
1000010000010000010000010000000000000000000000000000000000000000000000000001000001000001000001000001
1000010000010000010000010000000000000000000000000000000000000000000000000001000001000001000001000001
1000010000010000010000010000000000000000000000000000000000000000000000000001000001000001000001000001
1000010000010000010000010000000000000000000000000000000000000000000000000001000001000001000001000001
1000010000010000010000010000000000000000000000011001100000000000000000000001000001000001000001000001
1000010000010000010000010000000000000000000000010000100000000000000000000001000001000001000001000001
1000010000000000010000000000000000000000000000010EE0100000000000000000000000000001000000000001000001
1000010000000000010000000000000000000000000000010EE0100000000000000000000000000001000000000001000001
1000010000010000010000010000000000000000000000010000100000000000000000000001000001000001000001000001
1000010000010000010000010000000000000000000000011001100000000000000000000001000001000001000001000001
1000010000010000010000010000000000000000000000000000000000000000000000000001000001000001000001000001
1000010000010000010000010000000000000000000000000000000000000000000000000001000001000001000001000001
1000010000010000010000010000000000000000000000000000000000000000000000000001000001000001000001000001
1000010000010000010000010000000000000000000000000000000000000000000000000001000001000001000001000001
1000010000010000010000010000000000000000000000000000000000000000000000000001000001000001000001000001
1000010000010000010000010000000000000000000000000000000000000000000000000001000001000001000001000001
1000010000010000010000010000000000000000000000000000000000000000000000000001000001000001000001000001
1000010000010000010000010000000000000000000000000000000000000000000000000001000001000001000001000001
1000010000010000010000010000000000000000000000000000000000000000000000000001000001000001000001000001
1000010000010000010000010000000000000000000000000000000000000000000000000001000001000001000001000001
1000010000010000010000010000000000000000000000000000000000000000000000000001000001000001000001000001
1000010000010000010000010000000000000000000000000000000000000000000000000001000001000001000001000001
1000010000010000010000010000000000000000000000000000000000000000000000000001000001000001000001000001
1000010000010000010000010000000000000000000000000000000000000000000000000001000001000001000001000001
1000010000010000010000010000000000000000000000000000000000000000000000000001000001000001000001000001
1000010000010000010000010000000000000000000000000000000000000000000000000001000001000001000001000001
1000010000010000010000010000000000000000000000000000000000000000000000000001000001000001000001000001
1000010000010000010000010000000000000000000000000000000000000000000000000001000001000001000001000001
1000010000010000010000010000000000000000000000000000000000000000000000000001000001000001000001000001
1000010000010000010000010000000000000000000000000000000000000000000000000001000001000001000001000001
1000010000010000010000010000000000000000000000000000000000000000000000000001000001000001000001000001
1000010000010000010000010000000000000000000000000000000000000000000000000001000001000001000001000001
1000010000010000010000010000000000000000000000000000000000000000000000000001000001000001000001000001
1000010000010000010000011111111111111111111111111111111111111111111111111111000001000001000001000001
1000010000010000010000000000000000000000000000000000000000000000000000000000000001000001000001000001
1000010000010000010000000000000000000000000000000000000000000000000000000000000001000001000001000001
1000010000010000010000000000000000000000000000000000000000000000000000000000000001000001000001000001
1000010000010000010000000000000000000000000000000000000000000000000000000000000001000001000001000001
1000010000010000010000000000000000000000000000000000000000000000000000000000000001000001000001000001
1000010000010000011111111111111111111111111111110011111111111111111111111111111111000001000001000001
1000010000010000000000000000000000000000000000000000000000000000000000000000000000000001000001000001
1000010000010000000000000000000000000000000000000000000000000000000000000000000000000001000001000001
1000010000010000000000000000000000000000000000000000000000000000000000000000000000000001000001000001
1000010000010000000000000000000000000000000000000000000000000000000000000000000000000001000001000001
1000010000010000000000000000000000000000000000000000000000000000000000000000000000000001000001000001
1000010000011111111111111111111111111111111111111111111111111111111111111111111111111111000001000001
1000010000000000000000000000000000000000000000000000000000000000000000000000000000000000000001000001
1000010000000000000000000000000000000000000000000000000000000000000000000000000000000000000001000001
1000010000000000000000000000000000000000000000000000000000000000000000000000000000000000000001000001
1000010000000000000000000000000000000000000000000000000000000000000000000000000000000000000001000001
1000011111111111111111111111111111111111111111110011111111111111111111111111111111111111111111000001
1000000000000000000000000000000000000000000000000000000000000000000000000000000000000000000000000001
1000000000000000000000000000000000000000000000000000000000000000000000000000000000000000000000000001
1000000000000000000000000000000000000000000000000000000000000000000000000000000000000000000000000001
1000000000000000000000000000000000000000000000000000000000000000000000000000000000000000000000000001
1000000000000000000000000000000000000000000000000000000000000000000000000000000000000000000000000001
1111111111111111111111111111111111111111111111111111111111111111111111111111111111111111111111111111